111111111
000000001
101110101
100010101
101111111
100000001
111111101